.B..B..B..
.T.T.T.T..
.F.F.F.F..
....T.....
..........