..B....B..
..T.T.T...
...F.F.F..
..........
..........