....B.....
..T...T...
...F.F....
..........
..........